red: 0,A
cyan: 1
++++++++++++++++++
++++++++++++++++++
+      0A1   a++++
+++++++++ ++++++++
++++++++++++++++++
++++++++++++++++++