red: 0,A
green: 1,B
++++++++++++++++++++++++++++
++++++++++++    AAAA       +
+ a 0 Aaaaa                +
++++++++++++++++++++++++++++
++++B 1  b           +++++++
++++++++++++++++++++++++++++