red: 0,A
green: 1,2,3,4,5
+++++++++++
+        a+
+++++ +++++
+         +
+ +++3+++ +
+ +     + +
+ + +++ + +
+ + 102 +5+
+ + +++ + +
+ +     + +
+ +++4+++ +
+    A    +
+++++++++++
