red: 0, A
blue: 1, B
+++++++++++++
++++b0 1a++++
++++++ ++++++
++++++ ++++++
++++++ ++++++
+++++A B+++++
+++++++++++++