blue: 0,A,E
red: 1,B,F
++++++++++++++++++++++++
+ a                A   +
+       +++   ++       +
+    B  ++++++++       +
+        b             + 
+                0     +
+ e     ++++++++ 1 E   +
+ f        F           +
++++++++++++++++++++++++