red: 0,A
green: 1,B
++++++++++++++++++++++++++++
++++++++++++ 0   AA        +
+a  a   a        A   +++++++
++++++++++++++++++++++++++++
++++B 1  b           +++++++
++++++++++++++++++++++++++++