red: 0,A
green: 1,B
++++++++++++
+  0     +a+
+ ++++++++A+
+B     b   +
++++++++++ +
+bB      1 +
++++++++++++
