red: 0,A
green: 1,B
+++++++++++++++++++++++++++++++++++++++++++++++++++++++++++++++++++++
+                                                                   +
+                                                                   +
+                                                                   +
+             0                                                     +
+                                                                   +
+                                                                   +
+                                                                   +
+                                                                   +
+                                                                   +      
+                                                                   +
+                                                                   +
+                                                                   +
+                                             A                     +
+                                                                   +
+                         A                a                        +
+                                          a                        +
+                                         Aa                        +
+             A                            a                        +
+                                                                   +
+                                                                   +
+                                                                   +
+                                                                   +
+                                                                   +
+                                                                   +
+                                                                   +
+                                          1B                  b    +
+                                                                   +
+                                                                   +
+                                                                   +
+                                                                   +
+                                                                   +
+                                                                   +
+                                                                   +
+                                                                   +
+                                                                   +
+                                                                   +
+                                                                   +
+                                                                   +
+                                                                   +
+                                                                   +
+                                                                   +
+                                                                   +
+                                                                   +
+                                                                   +
+                                                                   +
+                                                                   +
+                                                                   +
+                                                                   +
+                                                                   +
+                                                                   +
+                                                                   +
+                                                                   +
+                                                                   +
+                                                                   +
+                                                                   +
+                                                                   +
+                                                                   +
+                                                                   +
+                                                                   +
+                                                                   +
+                                                                   +
+                                                                   +
+                                                                   +
+                                                                   +
+                                                                   +
+                                                                   +
+                                                                   +
+++++++++++++++++++++++++++++++++++++++++++++++++++++++++++++++++++++