+++++++++++++++++++
+ A             0 +
+ a  A A A AAA ++++
+                 +
+              ++ +
+               + +
+++++++++++++++++++
