+++++++++++++
++++1b a0   +
++++++ ++++ +
++++++ ++++ +
++++++ ++++ +
+++++A B    +
+++++++++++++