red: 0,A
blue: 1,B
+++++++++++++++++++
+        0        +
+       +++       +
+   +++  a   ++   +
+       +++       +
+  +++++++++++++  +
+        +        +
+    +  A B  +    +
+                 +
+  ++++++++++++++++
+     ++++++++    +
+   ++   b   ++   +
+       +++       +
+        1        +
+++++++++++++++++++
