red: 0,A
blue: 1, B
++++++++++++++++
+              +
+  0A   b     a+
+      1B      +
++++++++++++++++