red: 0, A
blue: 1, B
+++++++++++++
++++a0 1B++++
++++++ ++++++
++++++ ++++++
+++++  ++++++
+++++b A+++++
+++++++++++++