red: 0,2,A,C
green: 1,B
++++++++++++++++++++++++++++
++++++++++++ 0   AA    a   +
+a    A     a+++  ++ +++++++
+ ++++++++++++++++++  c2  C+
++++B 1  b           +++++++
++++++++++++++++++++++++++++