red: 0,A
blue: 1,B
+++++++++++++
++++0b a1++++
++++++ ++++++
++++++ ++++++
++++++ ++++++
+++A     B+++
+++++++++++++