red: 0,A
green: 1,B
++++++++++++++++++++++++++++
++++++++++++     AAA       +
+Aaaaa 0                   +
++++++++++++++++++++++++++++
++++B 1  b           +++++++
++++++++++++++++++++++++++++