red: 0,A,C
++++++++++++++++++++++++++++
++++++++++++ 0   AA    a   +
+a    A     a+++  ++++++++++
+ +++++++++++++++++        +
++++++++++++++++++++++++++++
++++++++++++++++++++++++++++