+++++++++++
+0      Aa+
+++ +++ +++
+++ +++ +++
+++ +++ +++
+++ +++ +++
+++ +++ +++
+++ +++ +++
+++ +++ +++
+++A+++A+++
+++a+++a+++
+++++++++++