red: 0,A
green: 1,B
+++++++++++++++++++++++++++++++++++++++++++++++++++++++++++++++++++++
+                                                                   +
+                                                                   +
+                                                                   +
+             0                                                     +
+                                                                   +
+                                                                   +
+                                                                   +
+                                                                   +
+                                                                   +      
+                                                                   +
+                                                                   +
+                                                                   +
+                                                                   +
+                                                                   +
+                                                                   +
+                                                                   +
+                                                                   +
+                                   A      a                        +
+                                                                   +
+                                                                   +
+                                                                   +
+                                                                   +
+                                                                   +
+                                                                   +
+                                                                   +
+                                          1B                  b    +
+                                                                   +
+                                                                   +
+                                                                   +
+                                                                   +
+                                                                   +
+                                                                   +
+                                                                   +
+                                                                   +
+                                                                   +
+                                                                   +
+                                                                   +
+                                                                   +
+                                                                   +
+                                                                   +
+                                                                   +
+                                                                   +
+                                                                   +
+                                                                   +
+                                                                   +
+                                                                   +
+                                                                   +
+                                                                   +
+                                                                   +
+                                                                   +
+                                                                   +
+                                                                   +
+                                                                   +
+                                                                   +
+                                                                   +
+                                                                   +
+                                                                   +
+                                                                   +
+                                                                   +
+                                                                   +
+                                                                   +
+                                                                   +
+                                                                   +
+                                                                   +
+                                                                   +
+                                                                   +
+                                                                   +
+++++++++++++++++++++++++++++++++++++++++++++++++++++++++++++++++++++