red: 0,2,A,C
green: 1,B
++++++++++++++++++++++++++++
++++++++++++     AA    a   +
+a  0 A     a++   ++ +++++++
++++++++++++++++++++  c2  C+
++++B 1  b           +++++++
++++++++++++++++++++++++++++