blue: 0,A,B
red: 1,C
++++++++++
++++0+++++
++++ +++++
++++ ABC++
+ 1  ab c+
++++    ++
++++++++++
