#############
####0b a1####
###### ######
###### ######
###### ######
###A     B###
#############